111111111111111111
1U1L00000000000001
101111110000000001
100000000000000001
10000000PCE0000001
100000000000000001
100001010000000001
100001010000001111
100001D100000000R1
111111111111111111
