111111111
10000R001
100000001
1000PCE01
111111111
