111111111111111111111111111111
111000010000000011111111111111
11100P0000000C0000000000011111
111000000001000000000000011111
111000000000000011111101111111
111111111111111111111101111111
111111111111111111111101111111
111111111111111111111101111111
111111111110000000000000000011
1111111111100011000100100E0111
111111111111111111110010000011
111111111110000000011110000111
111111111110001000000000000011
111111111111111111111111111111
