111111111111111111
100000110000000001
10000011000R000001
100000000000001111
100U00000000001111
100000000000000D01
100000000000000001
1000000P0000000001
1000000E0000111111
10000000000000L0C1
111111111111111111
